1111111111111
100P00E00C0C1
1111111111111