1111111111111
1PCCCCCCCCCE1
1111111111111