1111111111
10000001E1
1000000001
1P00C000N1
1111111111