11111111111111111111111111111111111
1E0011000000000C00000C000000000001
10N0010000100000101001000000010101
1111000000101010001001000000010101
1P0000000C01C1000000000000000000C1
1111111111111111111111111111111111